22,22,
7,2,2,2,2,2,2,2,2,2,2,2,2,2,2,2,2,2,2,2,2,8,
0,3,3,3,3,3,3,3,3,3,3,3,3,3,3,3,3,3,3,3,3,1,
0,13,13,13,13,13,13,13,13,13,13,13,13,13,13,13,13,13,13,13,13,1,
0,13,13,13,13,13,13,13,13,13,13,13,13,13,13,13,13,13,13,13,13,1,
0,13,13,13,13,13,13,13,13,13,13,13,13,13,13,13,13,13,13,13,13,1,
0,13,13,13,13,13,13,13,13,13,13,13,13,13,13,13,13,13,13,13,13,1,
0,13,13,13,13,13,13,13,13,13,13,13,13,13,13,13,13,13,13,13,13,1,
0,13,13,13,13,13,13,13,13,13,13,13,13,13,13,13,13,13,13,13,13,1,
0,13,13,13,13,13,13,13,13,13,13,13,13,13,13,13,13,13,13,13,13,1,
0,13,13,13,13,13,13,13,13,13,13,13,13,13,13,13,13,13,13,13,13,1,
0,13,13,13,13,13,13,13,13,13,13,13,13,13,13,13,13,13,13,13,13,1,
0,13,13,13,13,13,13,13,13,13,13,13,13,13,13,13,13,13,13,13,13,1,
0,13,13,13,13,13,13,13,13,13,13,13,13,13,13,13,13,13,13,13,13,1,
0,13,13,13,13,13,13,13,13,13,13,13,13,13,13,13,13,13,13,13,13,1,
0,13,13,13,13,13,13,13,13,13,13,13,13,13,13,13,13,13,13,13,13,1,
0,13,13,13,13,13,13,13,13,13,13,13,13,13,13,13,13,13,13,13,13,1,
0,13,13,13,13,13,13,13,13,13,13,13,13,13,13,13,13,13,13,13,13,1,
0,13,13,13,13,13,13,13,13,13,13,13,13,13,13,13,13,13,13,13,13,1,
0,13,13,13,13,13,13,13,13,13,13,13,13,13,13,13,13,13,13,13,13,1,
0,13,13,13,13,13,13,13,13,13,13,13,13,13,13,13,13,13,13,13,13,1,
0,13,13,13,13,13,13,13,13,13,13,13,13,13,13,13,13,13,13,13,13,1,
5,4,4,4,4,4,4,4,4,4,4,4,4,4,4,4,4,4,4,4,4,6,