22222222222222222222222222222222222222222
33333333333333333333333333333333333333333
05555555555555555555555555555555555555551
05555555555555555555555555555555555555551
05555555555555555555555555555555555555551
05555555555555555555555555555555555555551
05555555555555555555555555555555555555551
05555555555555555555555555555555555555551
05555555555555555555555555555555555555551
05555555555555555555555555555555555555551
05555555555555555555555555555555555555551
05555555555555555555555555555555555555551
05555555555555555555555555555555555555551
05555555555555555555555555555555555555551
44444444444444444444444444444444444444444